26 15
10 10 10 10 10 10 10 10 10 10 10 10 10 10 10 10 10 10 10 10 10 10 10 10 10 10
10 10 10 10 10 10 10 0 0 0 0 0 10 0 0 0 0 0 0 0 0 0 0 0 0 10
10 10 10 10 10 10 0 0 0 0 0 0 10 0 0 0 0 0 0 0 0 0 0 0 0 10
10 10 10 0 0 0 0 0 0 0 0 0 10 0 0 0 0 0 0 0 0 0 0 0 0 10
10 10 0 0 0 0 0 0 0 0 0 10 10 0 0 0 0 0 0 0 0 0 0 0 0 10
10 0 0 0 0 0 0 0 10 10 10 10 10 0 0 0 0 0 0 0 0 0 0 0 0 10
10 0 02 0 10 0 0 10 10 10 10 10 10 0 0 0 0 0 0 0 0 0 0 0 0 10
10 0 0 0 0 0 0 0 10 10 0 0 0 0 0 0 0 0 0 0 0 0 0 0 0 10
10 10 0 0 0 0 0 0 10 0 0 0 0 0 0 0 0 0 0 0 0 0 0 0 10 10
10 0 0 0 10 0 0 0 0 0 0 0 0 0 0 0 0 0 0 0 0 10 0 0 0 10
10 0 0 0 0 0 0 00 0 0 0 0 0 0 0 10 10 10 0 0 0 0 0 0 0 10
10 0 0 0 0 0 0 10 0 0 0 10 10 10 10 10 10 10 10 0 0 0 0 0 0 10
10 10 10 10 10 10 10 10 10 10 10 10 10 10 10 10 10 10 10 10 10 10 10 10 10 10
10 10 10 10 10 10 10 10 10 10 10 10 10 10 10 10 10 10 10 10 10 10 10 10 10 10
5 10 10 10 10 10 10 10 10 10 10 10 10 10 10 10 10 10 10 10 10 10 10 10 10 10
